++++++++++++++++++++++++++++++++++++++++++++++++++++++++++++++++
+                   +          +            +                  +
+++++++++++++++ +++ +++++++  + +++++ ++ +++++++   ++++++++++ +++
++       +        +        +++       +         ++ +            +
+  +++++  + ++++++++++++++ +++++++ ++++++++++ +   + +++++++++ ++
++      + + +      +           S           +  + +++         +  +
+++++++++ + + ++++ +++++++++++ +++++++++++++ ++     +++++++++ ++
+       +   + +                            + ++++++ +          +
+++++++ + +++ + ++ + +++++++++++++++ +++++          ++++++++++++
+       + +   ++ + + +         +          +++++++ ++++         +
+ +++++++ +  +     +  + ++++++++ + ++++++       + +    +++++++ +
+         + ++ ++ ++           + +      +++++++ + + ++++    ++ +
+++++++++++ +  +   +  ++++++++ + ++++++       + + + + ++ ++ ++ +
+ +       + + +++++++          +    +  + +  + + + +      +   + +
+ + +++++   + +       +++++++ +++++++ +++ ++  + + ++++++++++++ +
+ + +     + +  + +++ +    +++ ++ + +         ++ +              +
+   + +++++ +  + + + + + +           ++ + + + + ++++++++ +++++++
+++++ +     +  +   +   + +++++++++++ + + + ++ +        + +     +
+     + ++++++++++ ++++           ++        + ++++++++ + + +++ +
+++++++++          +++++++++++ + + ++++++++++     +++  + + + + +
+ +       ++ + ++++            +     +        ++++    +  + + + +
+ ++++++++++ + +    ++++++  + +++++++++++++++++++++++ +      + +
+            + +++++++++++  +                       +  +  ++ + +
+ +++++++++++++            ++++++++++++++++++++++++ + +  + + + +
+ + ++   ++++ + ++++++++++           +              + + +    + +
+      +      + +        +++++++++ + + ++++++++++++++ ++++++++ +
+++++++++++++++ + ++++++++    + + ++ + +                       +
+               + +          +       + ++++++++++++++ ++++++++++
+ ++++++++++++++  + ++++++ ++++++++++++             + +        +
+           +    +       + +            +++++++++++ + + ++++++ +
+++++++++++ + ++++++++++ + + +++++++++++   +     +  + + +    + +
+           +            + + +           +   +++++ ++ + ++++ + +
++++++++++++++++++++++++++ + +++++++++++++++ +   +    +      + +
  +                        +                 + +  + ++++++++++ +
+ + ++++++++++++ +++++++++ +++++++++++++++++++ ++ +            +
+ + +          +++ + + + ++ +     ++++       +  + ++++++++ + +++
+ + + +++ ++ + + +     + +  + ++++     +++++    +     + +   ++ +
+ +     + +  + + + +++ + +  + +    ++ ++  ++++++++++ +       + +
+ +++++++ + ++ + +   + + +  + ++ +++               + + +++++ + +
+ +     +++   ++++++++ ++++++ ++ ++++++++++++++ ++ + + + + + + +
+ + +++ + +++ +           +   +  +    +       + ++ + +     + + +
+ + +   +       +++ ++ +++ ++++ +  +  +++++++ ++  ++ +++++++ + +
+ + + +++++++++++ +++ ++ + + ++ ++++          ++               +
+ + +                    + + ++      + + +++++++++++++++++++++ +
+ + ++++++++++++++++++++ +++ +++++++++ + +                   + +
+ +              +       +             + +++++++++++++++++++ + +
+ ++++++++++++++ ++ ++++++++++++++++++++ +                   + +
+ +        +      + +        ++ +        + ++++++++++++++++ ++ +
+ + ++++++ + +++ ++ + ++++++ ++ + ++++++++ +                 + +
+   + + +  + + +  + + +      ++ +          + +++++++++++++++++ +
+++ + + + ++ + +++  + + +++++++ + ++++++++++                 + +
+ + + + +   +  ++    + +    +  +  +        + +++++++++++++++++++
+ + + + +  + +     ++++  + + +++ +  ++++++++ +                 +
+ + +      + + + ++      + +       +         + +++++++++++++++ +
+ + ++++++++ + + +  ++++ +  + +   +  ++++++  + +             + +
+ +          + ++++++++++++ + + ++  +     ++ + + +++++++++++ + +
+ +++++++++ +             + + + ++ +++++ +++ + + + + + + + + + +
+           + +++++++++++ +   + +    + +     + + + +         + +
+++++++++++ + ++ +        + + + ++++ + +++++++ + + + +++++++++ +
+           +  + + ++++++++ + + +    +       + + +   +         +
+ ++++++++++  ++ +      +++ ++  ++++++++++++ + + +++++ +++++++ +
+      +    +  + + ++++     +                + +       +     + +
++++++ + ++ ++ + + + +   + +++++++++++++++++++ +++++++ +++++ + +
+        +     +   + + ++                      +             + +
++++++++++++++++++++++++++++++++++++++++++++++++++++++++++++++++
